2 2 0 0 0 0 0 0 0 0 0 0 0 0 0 0 0 0 0 0 0 0 0 0 0
2 2 2 7 7 1 1 1 1 1 1 8 6 6 8 1 1 1 1 1 1 1 1 1 0
0 2 2 2 7 1 1 1 1 1 1 5 6 6 5 1 1 7 1 1 1 1 7 1 0
0 1 2 2 2 1 1 7 7 1 1 5 6 6 5 1 1 1 1 8 8 1 1 1 0
0 1 1 2 2 2 1 7 7 1 1 8 6 6 8 1 1 1 1 1 1 1 1 1 0
0 1 1 6 4 4 4 6 6 6 6 6 6 6 6 6 6 6 6 6 6 6 6 6 0
0 1 1 6 6 4 4 4 6 6 6 6 6 6 6 6 6 6 6 6 6 6 6 6 0
0 1 1 6 6 1 2 2 2 1 1 1 1 1 1 1 7 1 1 1 1 1 1 1 0
0 1 1 6 6 1 1 2 2 2 1 1 1 7 1 1 1 7 1 7 1 1 1 1 0
0 1 1 6 6 1 1 1 2 2 2 1 1 1 7 1 1 1 1 1 1 1 1 1 0
0 1 1 6 6 1 1 1 1 2 2 2 2 2 2 1 1 1 1 1 1 1 1 1 0
0 1 1 6 6 6 6 6 6 4 4 4 4 4 4 6 6 6 6 6 6 6 1 1 0
0 1 1 6 6 6 6 6 6 4 4 4 4 4 4 6 6 6 6 6 6 6 1 1 0
0 1 1 1 1 1 1 1 1 2 2 2 2 2 2 8 8 8 8 8 6 6 1 1 0
0 8 1 1 8 1 1 1 1 1 1 1 1 2 2 2 8 8 8 8 6 6 1 1 0
0 8 1 1 8 8 1 1 1 1 7 1 1 1 2 2 2 8 8 8 6 6 1 1 0
0 1 1 1 1 8 1 1 1 1 7 7 1 1 1 2 2 2 8 8 6 6 1 1 0
0 1 1 1 1 1 1 1 1 1 7 7 1 1 1 1 2 2 2 8 6 6 1 1 0
0 6 6 6 6 6 6 6 6 6 6 6 6 6 6 6 6 4 4 4 6 6 1 1 0
0 6 6 6 6 6 6 6 6 6 6 6 6 6 6 6 6 6 4 4 4 6 1 1 0
0 1 8 1 1 1 1 1 1 1 8 6 6 8 1 1 1 1 1 2 2 2 1 1 0
0 1 1 1 8 8 1 1 1 1 5 6 6 5 1 1 1 1 1 1 2 2 2 1 0
0 1 1 1 8 1 1 1 1 1 5 6 6 5 1 1 1 7 7 1 1 2 2 2 0
0 1 1 1 1 1 1 1 1 1 8 6 6 8 1 1 1 1 1 1 1 1 2 2 2
0 0 0 0 0 0 0 0 0 0 0 0 0 0 0 0 0 0 0 0 0 0 0 2 2