0 0 0 0 0 0 0 0 0 0 0 0 0 0 0 0
0 1 8 1 1 6 6 6 1 6 6 6 1 8 1 0
0 1 6 6 6 6 8 6 6 6 7 6 6 6 1 0
0 1 6 6 1 6 6 6 8 1 1 1 6 6 1 0
0 1 6 6 1 1 2 2 2 2 1 1 6 6 1 0
2 2 4 4 2 2 2 2 2 2 2 2 4 4 2 2
2 2 4 4 2 2 2 2 2 2 2 2 4 4 2 2
0 1 6 6 1 1 2 2 2 2 1 1 6 6 1 0
0 1 6 6 1 1 1 5 5 1 1 1 6 6 1 0
0 1 6 6 6 6 6 6 6 6 8 6 6 6 1 0
0 1 8 1 1 7 1 1 1 6 6 6 1 8 1 0
0 0 0 0 0 0 0 0 0 0 0 0 0 0 0 0